1111111111111111111111111111111119
3311111111111111111111111111111119
1111222211111111111111111111111119
1111111111111111111111111111111119
1111111111111111111111111111111119
3333333333333333333333333333333339
